0,0,0,0,0,0,0,0,0,0,0,0,W
0,0,0,0,0,0,0,0,0,0,0,0,0
0,0,0,W,0,0,0,0,0,0,0,0,0
W,W,W,W,W,W,W,0,W,W,W,W,W
1,1,1,1,1,1,1,1,1,1,1,1,1
1,1,1,1,1,1,1,1,1,1,1,1,1
1,1,1,1,1,1,1,1,1,1,1,1,1
1,1,1,1,1,1,1,1,1,1,1,1,1
W,W,W,W,W,W,W,2,W,W,W,3,W
2,2,2,2,2,2,2,2,2,2,W,3,3
2,2,2,2,2,2,2,2,2,2,W,3,3
2,2,2,2,2,2,2,2,2,2,W,3,3
2,2,2,2,2,2,2,2,2,2,W,3,3